11111111111111111111111111
10000000000000000000C00001
10000010000000000000000001
1000001C000000000000000001
10E00011100000000001111111
10000010001111111111C00001
11111111111C00000000000001
10P00000000000000000000001
1000000000000000C000000001
11111111111111111111111111
